11111
10001
100P1
1C0E1
11111
