1111111111111
10010000000C1
100001111P001
1P0011E0000E1
1111111111111