11111111111111111111
1E0000000000000C0001
10100101001000001011
10100100101010100011
1P0000000C00C0000001
10100101001000001011
100000000000000C0001
100000000000000C0001
11111111111111111111
